1111111111
1011111M01
1P000EC001
1111111111