111111111111111111111111111111
1000000000C00000011100011000C1
1C01111011110000000000C0000001
101000100000011111110000000001
101001100M0001000000000MM00001
10101010000001C000000111100001
101100100000010000000000000001
100011011000011111100000000001
1000000C00000100000000C0000001
101001111111110111111111111111
100011001000010000000000000001
100011P01000011111111100000M01
10M000000000100000000000E00001
111111111111111111111111111111
