1111111111
10PC110E01
1111111111
1111110001
1000110001
1111111111