11111111111111111111111111111111111111111111
1000000000C0000001110001100000000000000000C1
1C01111011110000000000C000000000000000000001
10100010000001111111000000000000000000000001
10100110000001000000000000000000000000000001
10101010000001C00000011110000000000000000001
10110010000001000000000000000000000000000001
10001101100001111110000000000000000000000001
1000000C00000100000000C000000000000000000001
10100111111111011111111111000000000000001111
10001100100001000000000000000000000000000001
10001100100001000000000000000000000000000001
10001100100001000000000000000000000000000001
10001100100001000000000000000000000000000001
10001100100001000000000000000000000000000001
10001100100001000000000000000000000000000001
10001100100001000000000000000000000000000001
10001100100001000000000000000000000000000001
10001100100001000000000000000000000000000001
10001100100001000000000000000000000000000001
100011P0100001111111110000000000000000000001
100000000000100000000000E0000000000000000001
11111111111111111111111111111111111111111111
